111111
100001
100011
1c1001
1p0001
111111
